{abase: "(v) lower; degrade; humiliate; make humble; make (oneself) lose self-respect",
abash: "(v) make (someone) feel embarrassed, disconcerted, or ashamed",
abate: "(v) subside or moderate",
abbreviate: "(v) shorten",
abdicate: "(v) renounce, give up; fail to fulfill or undertake (a responsibility or duty),
aberrant: "(v) abnormal or deviant",
aberration: "a departure from what is normal, usual, or expected, typically one that is unwelcome",
abet: "(v) encourage or assist (someone) to do something wrong, eg. committing a crime",
abeyance: "(n) a state of temporary disuse or suspension, eg. "matters were held in abeyance pending further inquiries",
abhor: "(v) detest; hate",
abject:	"(adj) 1. (of something bad) experienced or present to the maximum degree, eg. abject misery; 2. (of a person or their behavior) completely without pride or dignity, eg. abject apology",
abjure: "(v) trenounce upon oath; solemnly renounce",
ablution: "(n) the act of washing oneself, eg. Sally performed her morning ablutions which consists of ...",
abnegation: "(n) the act of renouncing or rejectin something; self denial",
abolish: "(v) to formally put an end to",
abominate: "(v) to detest; loathe",
abominable: "(adj) causing moral revulsion; very bad or unpleasant",
aboriginal: "(adj) native or indigenous to a region; (n) an aboringinal inhabitant of a place",
abortive: "(adj) failing to produce the intendedresult; unsuccessful; fruitless",
abrasive: "(adj) rubbing away; tending to grind down; harsh or showing little concern",
abridge: "(v) to condense or shorten (eg. a pieceof writing)",
abrogate: "(v) 1. to repeal or do away with (a law, a right, or a formal agreement); 2. evade (a reponsibility or duty)",
abscission: "(n) the act or process or cutting off; the natural separation of flowers, fruits, or leaves from plants at a special separation layer",
abscond: "(v) to leave hurriedly and secretly, typically to avoid detection of or arrest for an unlawful action such as theft; escape",
absolute: "(adj) complete, certain",
absolve: "(v) set or declare (someone) free from blame, guilt, or responsibility",
abstain: "(v) 1. refrain oneself from doing something; 2. formally decline to vote",
abstemious: "(adj) sparing in eating and drinking; temperate",
abstinence: "(n) the fact or practice of restraining onself from indulging in something",
abstract: "(adj) theoretical; not concrete; nonrepresentational",
representational: "(adj) relating to or characterized by representation; (of a style of art) showing things as they actually appear in real life",
abstruse: "(adj) obscure, difficult to understand",
abusive: "(adj) coarsely insulting; physically harmful"}



